11111111111111111111111111111111111111
1C000000000000000000000000100110000111
11110000000000000000000000000000000001
11111100000000000000000000110010100111
11110000000000000000000000000000000001
11111100000000000000000000110010100111
11110000000000000000000000000000000001
11111100000000000000000000110110100111
11110000000000000000000000000000000001
11111100000000000000000000110010100111
11110000000000000000000000000000000001
11111100000000000000000000110110100111
11110000000000000000000000000000000001
11111100000000000000000000110010100111
11110000000000000000000000000000000001
11111100000000000000000000110010100111
11110000000000000000000000000000000001
11111100000000000000000000110110101011
11110000000000000000000000000000000001
11111100000000000000000000100010100111
11110000000000000000000000000000000001
11111100000000000000000000100010100111
11110000000000000000000000000000000001
11111100000000000000000000110010100111
11110000000000000000000000000000000001
11111100000000000000000000110010100111
11110000000000000000000000000000000001
11111100000000000000000000110010100111
11110000000000000000000000000000000001
11111100000000000000000000110110100111
11110000000000000000000000000000000001
11111100000000000000000000110010100111
11110000000000000000000000000000000001
11111100000000000000000000000110100111
11110000000000000000000000000000000001
11111100000000000000000000100110100111
11110000000000000000000000000000000001
11111100000000000000000000110110100111
11110000000000000000000000000000000001
11111100000000000000000000110010100111
11110000000000000000000000000000000001
11111100000000000000000000100110100111
11110000000000000000000000000000000001
11111100000000000000000000110010100111
11110000000000000000000000000000000001
11111100000000000000000000110110100111
11110000000000000000000000000000000001
11111100000000000000000000110110100111
11110000000000000000000000000000000001
11111100000000000000000000110110100111
11110000000000000000000000000000000001
11111100000000000000000000110110100111
11110000000000000000000000000000000001
11111100000000000000000000110110100111
11110000000000000000000000000000000001
11111100000000000000000000110110100111
11110000000000000000000000000000000001
11111100000000000000000000110110100111
11110000000000000000000000000000000001
11111100000000000000000000110110100111
11110000000000000000000000000000000001
11111100000000000000000000110010000111
11110000000000000000000000000000000001
111111000000000000000000001101101C0111
11110000000000000000000000000000000001
11111100000000000000000000110110100111
11110000000000000000000000000000000001
11111100000000000000000000110110100111
11110000000000000000000000000000000001
11111100000000000000000000110110100111
11110000000000000000000000000000000PE1
11111111111111111111111111111111111111