1111111111111111111111111111111111111111111111111111111111111111111111111111111111111111111111111111111111111111111111111111111111111111111111
101100011C00110100010000000010111C1010001C10000000000000000C00000010000000100000000000000011011100010100111010111000100110100000010101C0110101
1000000000010100000100000000000000000000000000000000100000000000001000000010100000000000000000000000000000000000000000000000000000000000000001
11000111000000100111000000C000C0000000000C000000000100000000001111100000001C100000000000000000000000000000000000000000000000000000000000000001
1011010100001000010100000000000000000000000000000010000000000000000000000011100000000000000000000000000000000000000000000000000000000000000001
1000000000000000000000000000000000000000000000000100000000000000000000000000000000000000000000000000000000000000000000000000000000000000000001
1111000000000000000000000000000000000000000000001000000000000001111110000011101000000000000000000000000000000000000000000000000000000000000001
1000000000000000000000000000000000000000000000000100000000000000000001000010001000000000000000000000000000000000000000000000000000000000000001
1000100000010000100001000000000000000110111110000010011000011001C1000C10001000C11000101111000101010000010001010100000C1C111001C000001C00110101
101100011C0011010001000000001C11101010001010000000000000000000000100000001100000000C0110111000101000101100101011100000100110100000010101C00101
1000000000010100000100000000000000100000000000000000100000000000001000000010100000000000000000000000000000000000000000000000000000000000000001
110001110000001001110000000000000100000000000000000100000000001111100000001C100000000000000000000000000000000000000000000000000000000000000001
10110101000010000101000000000000100000000000000001000000000000000000000001110000000000000000000000000000000000000000000000000000000000000000E1
1000000000000000000000000000000001010000000000000100000000000000000000000000000000000000000000000000000000000000000000000000000000000000000001
1111000000000000000000P00000000000100000000000001C00000000000001111110000011101000000000000000000000000000000000000000000000000000000000000001
1000000000000000000000000000000000000000000000000100000000000000000001000010001000000000000000000000000000000000000000000000000000000000000001
1000100000010000100000000011C111110000010011000C1100101000C10001000C11000101111C000010101011101110101010100101010000C1C11100000001C01C00110101
1111111111111111111111111111111111111111111111111111111111111111111111111111111111111111111111111111111111111111111111111111111111111111111111