



11111111111111111111
1C1100011C0001C10001
1000E0000000C0000C01
11000C1100P000100111
10110101000010C000C1
11111111111111111111
